010101010100101010101001010101001010101000101010010101010010101001010101001010101001010101001
101010101011010101011110101011110100101010010101001010101001010100101010100101010010101001011
100000011111000000000000000000011111111111111111111111111111111111111111111111111111111111111
100000001110000000000000000000000111000000000000000000000000000000000000000000000000000000001
100000000010000000000000000000000010000000000000000000000000000000000000000000000000000000001
100000000000000111111111111111100000000000000000000000000000000000000000000000000000000000001
100000000000000000000000000000011111111111111111111100000000000000000000000000000000000000001
100000000000000000000000000000000000000000000000000011111110000000000000000000000000000000001
10000011111111111111111111111111111111111111000000000000000C000000001111111111111110000000001
100000000000000000000000000000000000000000001110000000000000000000000000000000000000000000001
100000000000000000000000000001100000000000000000000000000000000000000000000000000000000000001
100111111010000000000000000000000000000000000000000000000000000100000000111111000000000000001
100000C00000000011100000111111C11111000000000000000000000000000000000000000000000011111111001
100000000000111111100000000110000111111000000000000000000000000000000111011111111100000000001
100001001110000011100000000010000110000000000000000000000000001111111001011110000000000000001
11100000E00010000000000000000111111111111000000000000000000000010000000101P101000000000000011
110000001111000000000111111110000000000000000000000000000000000000000001010101111110000000001
10000000000000001111100000000000000001111111111111110000C000000000000001000100000010000000001
1000000111111111000000000000000000000C0000000000000011111111111111111111111111111011111110001
10000000000000000000000000000000000000000000000000000000000000000000C000000000000000000000001
10000000C0000000000000000000000000000000C0000000000000000000000000111111111111111111111000001
100000000000000000000000000000000000000000000000000000000000000C00000000110000000000000000001
111111111111111111111111111111111111111111111111111111111111111111111111111111111111111111111
