011111111111111111111111110
1C0000000000000000000000001
011100000000000000000000111
100C000000000111111111001P1
101000000000000000000000001
101110000000000000000000001
011100000001111111111000011
01E0C1000000000000000000011
111111111111111111111111110
