0110101010101010101010101
1101010101010101010101010
01P000000C00000C000000E11
1110101010101010101010101
0101010100010101010101010
1110001010001010001010101
0101010101000101010001010
1110100010100000101010101
0101010101010100010101010
111010101000101C101010101
0101010101010101010101010
