1111111111111111111111111111111111
1E1000000000000C00000C000000000001
1010010100100000101001111111C10101
1010010010101010001001111111010101
1010010010101010001001110000010101
1010010010101010001001110111010101
1010010010101010001001110011010101
1010010010101010001001011C11010101
1010010010101010001001011111010101
1010010010101010001001000000010101
1010010010101010001001000000010101
1P0000000C00C0000000000000000000C1
1010101010101010101010101010101010
0101010101111101011111110101010101
